111111111
100000001
10N0C0001
1P0CN00E1
10CN00001
100000001
111111111
