111111111111111111
100000000100000001
100000000100000001
100000C00100000001
100000000000000E01
1P0000000100000001
111111111111111111