11111111111
10000000001
100000C0001
10000000E01
1P000000001
10000000001
11111111111