1111111111
1000000001
1000N0C001
10P00CN0E1
1000CN0001
1000000001
1111111111
