111111111111111111
1000000001000C0001
10E000C00100000001
1000P000000C000E01
10000000000C000E01
1000000001000C0001
111111111111111111
