11111111111111
11000000000011
1000000C000001
10P000C1C00E01
1000000C000001
11000000000011
11111111111111