1111111111
1000000001
1000000001
10P0C00E01
10P0C00001
1000000001
1111111111
