11111111111111111111111111111
1000000N0000N00N00N0000N00001
10000N000CN00N00C000N000N0001
100P00000N000C000N000N000E001
100000N0C00000N000CN000000001
10000000N00N0000N00000N000001
11111111111111111111111111111
