1111111
1PNC0E1
1000N01
1111111